#
#Thu Oct 08 05:48:46 EDT 2020
Account=Konto
Related\ Media=Verwandte Medien
Asset\ is\ missing=Datei fehlt
Communities=Gemeinschaften
Approvals=Zulassungen
System\ Settings=Systemeinstellungen
Dashboard=Instrumententafel
Manager=Manager
Attachments=Anh\u00E4nge
Edit\ Library\ Intro=Bibliothek Intro bearbeiten
Annotations=Anmerkungen
There\ was\ a\ problem\ completing\ this\ request=Es gab ein Problem beim Abschluss dieser Anfrage
Language=Sprache
Logout=Logout
Search=Suche
My\ Account=Mein Konto
News\ Feed=Neuigkeiten
Settings=Einstellungen
Selected\ Media=Ausgew\u00E4hlte Medien
Applications=Anwendungen
Categories=Kategorien
Media=Medien
People=Menschen
Add\ Media=Medien hinzuf\u00FCgen
Login=Einloggen
Contact=Kontakt
EntermediaDB\ Blog=EntermediaDB Blog
closed=geschlossen
Close=schlie\u00DFen
Ok=in Ordnung
Share=Teilen
open=ge\u00F6ffnet
Edit\ your\ Community=Bearbeiten Sie Ihre Community
